9 8
..#####.
###...#.
#a@A..#.
###.Aa#.
#a##A.#.
#.#.a.##
#A..AAa#
#...a..#
########

See: https://en.wikipedia.org/wiki/Sokoban